16 16 16 16 16 16 16 16 16 16 16 16 16 16 16 16 16 16 16 16 16 16 16 16 16 16 16 16 16 16 16 16 16 16 16 16 16 16 16 16 16 16 16 16 16 16 16 16 16 16 16 16 16 16 16 16 16 16 16 16 16 16 16 16 16 16 16 16 16 16 16 16 16 16 16 16 16 16 16 16 16 16 16 16 16 16 16 16 16 23 18 18 18 18 18 19 18 18 18 18 
16 16 16 16 16 16 16 16 16 16 16 16 16 16 16 16 16 16 16 16 16 16 16 16 16 16 16 16 16 16 16 16 16 16 16 16 16 16 16 16 16 16 16 16 16 16 16 16 16 16 16 16 16 16 16 16 16 16 16 16 16 16 16 16 16 16 16 16 16 16 16 16 16 16 16 16 16 16 16 16 16 16 16 16 16 16 16 16 16 23 18 18 18 18 28 26 26 26 29 18 
16 16 16 16 16 16 16 16 16 16 16 16 16 16 16 16 16 16 16 16 16 16 16 16 16 16 16 16 16 16 16 16 16 16 16 16 16 16 16 16 16 16 16 16 16 16 16 16 16 16 16 16 16 16 16 16 16 16 16 16 16 16 16 16 16 16 16 16 16 16 16 16 16 16 16 16 16 16 16 16 16 16 16 16 16 16 16 16 16 23 18 28 26 26 27 1 1 1 23 18 
16 16 16 16 16 16 16 16 16 16 16 16 16 16 16 16 16 16 16 16 16 16 16 16 16 16 16 16 16 16 16 16 16 16 16 16 16 16 16 16 16 16 16 16 16 16 16 16 16 16 16 16 16 16 16 16 16 16 16 16 16 16 16 16 16 16 16 16 16 16 16 16 16 16 16 16 16 16 16 16 16 16 16 16 16 16 16 16 16 23 18 24 1 1 1 2 1 1 23 18 
16 16 16 16 16 16 16 16 16 16 16 16 16 16 16 16 16 16 16 16 16 16 16 16 16 16 16 16 16 16 16 16 16 16 16 16 16 16 16 16 16 16 16 16 16 16 16 16 16 16 16 16 16 16 16 16 16 16 16 16 16 16 16 16 16 16 16 16 16 16 16 16 16 16 16 16 16 16 16 16 16 16 16 16 16 16 16 16 16 23 18 24 1 1 1 1 1 1 23 18 
16 16 16 16 16 16 16 16 16 16 16 16 16 16 16 16 16 16 16 16 16 16 16 16 16 16 16 16 16 16 16 16 16 16 16 16 16 16 16 16 16 16 16 16 16 16 16 16 16 16 16 16 16 16 16 16 16 16 16 16 16 16 16 16 16 16 16 16 16 16 16 16 16 16 16 16 16 16 16 16 16 16 16 16 16 16 16 16 16 23 18 24 1 1 1 1 1 1 23 18 
16 16 16 16 16 16 16 16 16 16 16 1 1 1 1 1 255 242 242 242 242 242 242 255 1 1 1 1 1 1 1 1 1 1 1 1 1 1 2 1 1 1 1 1 1 1 1 1 1 1 1 1 1 1 1 2 1 1 1 1 1 1 1 1 1 1 1 1 1 1 1 1 1 1 2 1 1 1 1 1 1 16 16 16 16 16 16 16 16 23 18 24 1 1 1 1 1 1 23 18 
16 16 16 16 16 16 16 16 16 16 16 1 2 1 16 1 255 227 227 227 227 227 227 255 1 16 16 16 16 16 16 16 16 16 16 16 16 16 16 16 16 16 16 1 1 1 1 1 16 16 16 16 16 1 1 1 1 1 1 1 1 255 242 242 242 242 242 242 242 242 255 1 1 1 1 1 1 16 16 16 1 1 1 1 1 16 16 16 16 23 18 30 22 2 1 1 1 1 23 19 
16 16 16 16 16 16 16 16 16 16 16 1 1 1 1 1 255 227 127 128 128 129 227 255 1 1 16 16 16 16 16 16 16 16 16 16 16 16 16 16 16 16 16 16 1 1 2 16 16 16 16 16 16 1 1 1 1 1 16 16 1 255 227 227 227 227 227 227 227 227 242 242 255 1 1 1 16 16 16 16 16 16 1 1 1 16 16 16 16 23 18 18 24 1 1 1 1 2 23 18 
16 16 16 16 16 16 16 16 16 16 16 2 1 1 1 1 255 227 135 136 136 137 227 255 1 1 16 16 16 16 16 16 16 16 16 16 16 16 16 16 16 16 16 16 1 1 16 16 16 16 16 16 16 16 1 1 1 16 16 16 1 255 227 79 80 80 80 80 81 227 227 227 255 1 1 1 1 1 1 16 16 16 16 1 1 1 16 16 16 23 18 18 30 21 21 21 21 21 31 18 
16 16 16 16 16 16 16 16 16 16 16 255 242 227 242 242 242 227 135 136 136 137 227 255 1 1 1 16 16 16 16 16 16 16 1 1 1 1 16 16 16 16 16 16 1 1 16 16 16 16 16 16 16 16 16 1 1 16 16 16 1 255 227 87 88 88 88 88 119 80 81 227 255 1 16 1 1 1 1 1 1 1 1 1 1 1 16 16 16 23 18 18 18 18 18 18 18 18 18 18 
16 16 16 16 16 16 16 16 16 16 16 255 227 227 227 227 227 227 135 136 136 137 227 255 1 1 2 1 16 16 16 16 16 1 1 1 16 1 1 16 16 16 16 16 1 1 16 16 16 16 16 16 16 16 1 1 16 16 16 16 1 255 227 95 96 96 96 96 105 88 89 227 255 1 16 1 255 242 227 242 242 242 242 255 1 1 1 16 1 23 18 18 18 18 18 18 18 18 18 18 
16 16 16 16 16 16 16 16 16 16 16 255 227 171 172 173 227 227 143 144 144 145 227 255 1 1 1 1 1 1 1 1 1 1 1 1 1 1 1 1 16 16 16 16 1 1 1 16 16 16 16 16 16 16 1 1 16 16 16 1 1 255 227 227 227 227 227 227 95 96 97 227 255 1 16 1 255 227 227 227 227 227 227 255 1 1 1 1 1 23 18 18 18 18 18 18 18 18 18 18 
16 16 16 16 16 16 16 16 16 16 16 255 227 227 227 227 227 227 227 227 227 227 227 255 1 1 1 1 16 16 16 1 1 1 1 1 2 1 1 1 16 16 16 16 1 1 1 16 16 16 16 16 16 16 1 2 1 1 1 1 1 242 242 227 242 242 255 227 227 227 227 227 255 1 1 1 255 227 175 176 176 177 227 255 1 1 1 1 1 23 18 18 18 18 18 18 18 18 18 18 
16 16 16 16 16 16 16 16 16 16 16 242 242 227 242 242 242 242 242 242 242 242 242 242 1 1 1 16 16 16 16 1 1 16 16 1 1 1 1 1 16 16 16 16 16 1 1 1 1 1 16 16 16 1 1 1 1 1 1 1 1 1 1 1 1 1 242 242 242 242 242 242 242 1 1 1 255 227 183 184 184 185 227 255 1 1 16 1 1 23 18 18 18 18 18 18 18 18 18 18 
16 16 16 16 16 16 16 16 16 16 16 1 2 1 1 1 1 1 1 1 1 1 1 1 1 1 16 16 16 16 16 16 2 1 16 1 1 16 1 1 1 16 16 16 16 16 2 1 1 1 1 1 1 1 1 16 16 16 16 1 1 1 1 1 1 1 1 1 1 1 1 1 1 1 1 1 255 227 183 184 184 185 227 255 1 1 1 1 1 23 18 18 18 18 18 18 18 18 18 18 
16 16 16 16 16 16 16 16 16 16 16 1 16 16 16 1 1 1 16 16 16 16 16 16 16 16 16 16 16 16 16 16 1 1 1 1 1 1 16 16 1 16 16 16 16 16 16 16 1 1 1 1 1 1 16 1 16 16 16 16 1 1 1 1 1 1 1 1 1 1 1 16 1 1 1 255 242 227 183 184 184 185 227 255 1 1 1 2 1 23 19 18 18 18 18 18 18 18 18 18 
16 16 16 16 16 16 16 16 16 16 16 16 16 16 1 1 1 16 16 16 16 16 16 16 16 16 16 16 16 16 16 16 16 16 16 16 16 16 16 16 1 16 16 16 16 16 16 16 12 10 13 1 1 1 255 242 242 242 242 242 242 242 242 242 255 1 1 1 2 1 1 1 1 16 16 255 227 227 183 184 184 185 227 242 255 1 1 2 1 23 18 18 18 18 18 18 18 18 18 18 
16 16 16 16 16 16 16 16 16 16 16 16 16 16 1 1 1 16 16 16 16 16 16 16 16 16 16 16 16 16 16 16 16 16 16 16 16 16 16 16 1 16 16 16 16 16 16 16 8 3 7 1 1 1 255 227 227 227 227 227 227 227 227 227 242 255 1 1 1 1 1 1 1 16 16 255 227 175 217 184 184 185 227 227 255 1 1 1 1 23 18 18 18 18 18 18 18 18 18 18 
16 16 16 16 16 16 16 16 16 16 16 16 16 1 1 2 1 16 16 16 16 16 16 16 16 16 16 16 16 16 16 16 16 16 16 16 16 16 16 16 1 1 16 16 16 16 1 16 8 3 7 1 1 1 255 227 127 128 128 128 128 128 129 227 227 255 1 1 1 1 1 1 1 16 16 255 227 183 184 184 184 215 177 227 255 1 1 1 16 23 18 18 18 18 18 18 18 18 18 18 
16 16 16 16 16 16 16 16 16 16 16 16 1 1 1 1 1 1 16 16 16 16 16 16 1 1 1 1 1 1 16 16 16 16 16 16 16 16 16 16 16 1 16 16 16 16 16 2 8 3 7 1 1 1 255 227 135 136 136 136 136 136 167 129 227 255 1 16 1 1 1 1 1 16 16 255 227 183 184 184 184 184 185 227 255 1 1 1 1 23 18 18 18 18 18 18 18 18 18 18 
16 16 16 16 16 16 16 16 16 16 16 16 1 1 1 1 1 1 1 1 1 1 1 1 1 1 1 1 1 1 1 1 1 1 1 1 1 16 16 16 16 1 16 16 16 16 16 1 8 3 7 1 1 16 255 227 143 144 144 144 144 144 144 145 227 255 1 16 1 1 1 2 1 1 1 255 227 183 184 184 184 184 185 227 255 1 1 1 1 23 18 18 18 18 18 18 18 18 18 18 
16 16 16 16 16 16 16 16 16 16 16 1 2 1 1 1 16 1 1 1 1 1 1 1 1 16 16 16 1 1 1 1 1 1 16 1 1 1 1 1 1 1 1 16 16 16 16 16 8 3 7 1 1 16 255 227 227 227 227 227 227 227 227 227 227 255 1 16 12 10 13 1 1 1 1 255 227 183 184 184 184 184 185 227 255 1 1 1 1 23 18 18 18 18 18 19 18 18 18 18 
16 16 16 16 16 16 16 16 16 16 16 1 1 1 1 16 16 16 16 1 1 1 1 1 1 1 16 1 1 1 1 2 1 1 1 1 1 1 16 16 1 1 1 16 16 16 16 16 8 3 7 1 1 1 242 242 242 242 242 242 242 242 242 227 242 242 1 1 8 3 7 1 1 1 1 255 227 183 184 184 184 184 185 227 242 255 1 1 1 23 18 18 18 18 18 18 18 18 18 18 
16 16 16 16 16 16 16 16 16 16 16 1 1 2 1 16 16 16 16 1 1 1 16 16 1 1 1 1 1 1 1 1 1 1 1 1 1 1 1 1 1 1 1 1 16 16 16 16 8 3 7 1 1 1 1 1 1 1 1 1 1 1 1 1 1 1 1 12 11 3 7 1 1 1 1 255 227 191 192 192 192 192 193 227 227 255 1 1 1 23 18 18 18 18 18 18 18 18 18 18 
16 16 16 16 16 16 16 16 16 16 16 1 1 1 1 16 16 16 1 1 1 1 16 16 1 1 1 1 1 1 1 1 1 1 1 1 1 1 1 1 1 1 16 1 16 16 16 16 8 3 7 1 1 1 1 1 1 1 1 1 1 1 2 1 1 1 1 8 3 3 7 1 1 1 1 255 227 227 227 227 227 227 227 227 227 255 1 1 1 23 18 18 18 18 18 18 18 18 18 18 
16 16 16 16 16 16 16 16 16 16 16 1 1 1 16 16 16 1 1 1 16 16 16 16 16 16 1 1 1 1 1 1 1 1 1 1 1 1 1 1 2 1 1 1 16 16 16 16 8 3 7 1 1 2 255 242 242 242 242 242 255 1 1 16 1 1 1 14 6 3 7 1 1 1 1 242 242 242 242 242 242 242 242 242 242 242 1 1 1 23 18 18 18 18 18 18 18 18 18 18 
16 16 16 16 16 16 16 16 16 16 16 1 1 1 16 16 16 1 2 1 16 16 16 16 16 16 16 1 1 1 1 1 1 1 1 1 1 1 1 1 1 1 1 1 16 16 16 16 8 3 7 1 1 16 255 227 227 227 227 227 242 255 1 1 1 1 1 1 8 3 9 10 13 1 1 1 1 1 1 1 1 1 1 16 16 16 1 1 1 23 18 18 18 18 18 18 18 18 18 18 
16 16 16 16 16 16 16 16 16 16 16 1 1 1 16 16 16 1 1 16 16 16 16 16 16 16 16 16 1 2 16 16 1 1 1 1 1 1 1 1 1 1 1 1 16 16 16 16 8 3 7 1 1 16 255 227 79 80 81 227 227 255 16 1 1 1 1 1 8 3 3 3 7 1 2 1 1 1 1 1 1 1 1 1 1 1 1 1 1 23 18 18 18 18 18 18 18 18 18 18 
16 16 16 16 16 16 16 16 16 16 16 1 1 1 16 16 1 2 1 16 16 16 16 16 16 16 16 16 1 1 16 16 16 16 2 1 1 1 1 1 1 1 1 1 16 16 16 16 8 3 7 1 16 1 255 227 87 88 119 81 227 255 16 16 1 1 1 1 8 3 4 5 15 1 1 1 1 1 1 1 1 1 1 1 1 1 1 1 1 23 18 18 18 18 18 18 18 18 19 18 
16 16 16 16 16 16 16 16 16 16 16 1 2 1 1 1 1 1 1 1 16 16 16 16 16 16 16 16 1 1 16 16 16 1 1 1 16 16 16 16 16 1 2 1 16 16 16 16 8 3 7 1 1 1 255 227 87 88 88 89 227 255 16 16 1 1 1 1 8 3 7 1 1 1 1 1 1 16 255 242 242 242 242 242 242 242 255 1 1 23 18 18 18 18 18 18 18 18 18 18 
16 16 16 16 16 16 16 16 16 16 16 1 1 1 1 1 1 1 1 1 16 16 16 16 16 16 16 16 1 1 16 16 1 1 1 16 16 16 16 16 16 16 1 1 16 16 16 16 8 3 7 1 1 1 255 227 87 88 88 89 227 255 16 16 1 1 1 1 8 3 7 1 1 1 1 1 16 16 255 227 227 227 227 227 227 227 255 1 1 23 18 18 18 18 18 18 18 18 18 18 
16 16 16 16 16 16 16 16 16 16 16 16 1 1 1 16 16 16 1 1 1 16 16 16 16 16 16 16 1 1 1 1 1 1 16 16 16 16 16 16 16 16 1 1 16 16 16 16 8 3 7 2 1 1 255 227 87 88 88 89 227 255 16 16 1 1 1 1 8 3 7 1 1 1 1 16 16 255 242 227 79 80 80 80 81 227 255 1 1 23 18 18 18 18 18 18 18 18 18 18 
16 16 16 16 16 16 16 16 16 16 16 16 1 1 1 1 16 16 16 1 1 16 16 16 16 16 1 1 1 1 1 1 1 16 16 16 16 16 16 16 16 1 1 16 16 16 16 16 8 3 7 1 1 16 255 227 95 96 96 97 227 255 16 2 1 1 1 1 14 5 15 1 1 1 1 16 16 255 227 227 87 88 88 103 97 227 255 1 1 23 18 18 18 18 18 18 18 18 18 18 
16 16 16 16 16 16 16 16 16 16 16 16 16 1 1 1 1 16 16 1 1 1 1 1 1 1 2 1 1 1 1 1 16 16 16 16 16 16 16 16 1 1 1 16 16 16 16 16 8 3 7 1 1 16 255 227 227 227 227 227 227 255 1 1 1 1 1 1 1 1 1 1 1 1 1 1 16 255 227 123 117 96 96 97 227 227 255 1 1 23 18 18 18 18 18 18 18 18 18 18 
16 16 16 16 16 16 16 16 16 16 16 256 233 227 233 256 1 1 16 1 1 1 1 1 1 1 1 1 16 16 1 1 1 16 16 16 16 1 1 2 1 1 16 16 16 16 16 16 8 3 7 1 1 1 242 242 227 242 242 242 242 242 1 1 1 1 1 2 1 1 1 1 1 1 1 1 1 255 227 227 227 227 227 227 227 255 242 1 1 23 18 18 18 18 18 18 18 18 18 18 
16 16 16 16 16 16 16 16 16 16 16 256 227 227 227 256 1 1 1 1 1 16 16 16 16 16 16 16 16 16 16 1 1 1 1 1 1 1 1 1 1 16 16 16 16 16 16 16 8 3 7 1 1 1 1 1 1 1 16 16 1 1 1 1 1 16 16 1 1 1 1 1 16 16 1 1 1 242 242 227 242 242 242 242 242 242 1 1 1 23 18 18 18 18 18 18 18 18 19 18 
16 16 16 16 16 16 16 16 16 16 16 256 227 78 227 256 16 1 1 1 1 1 1 2 1 1 1 1 1 1 1 1 1 1 1 1 1 1 1 16 16 16 16 16 16 16 16 16 8 3 7 1 1 1 1 1 1 1 1 1 1 1 1 1 16 16 16 16 1 1 1 1 16 16 16 1 1 1 1 1 1 1 1 1 1 1 1 1 16 23 18 18 18 18 18 18 18 18 18 18 
16 16 16 16 16 16 16 16 16 16 16 256 227 227 227 256 16 16 16 16 16 16 16 16 16 16 16 16 16 16 16 16 16 16 16 16 16 16 16 16 16 16 16 16 16 16 16 16 8 3 7 1 16 16 16 1 1 1 1 1 1 1 1 255 242 242 242 242 242 242 242 227 242 242 255 1 1 1 1 1 1 1 1 1 1 1 1 1 1 23 18 18 18 18 18 18 18 18 18 18 
16 16 16 16 16 16 16 16 16 16 16 233 232 233 233 234 16 16 16 16 16 16 16 16 16 16 16 16 16 16 16 16 16 16 16 16 16 16 16 16 16 16 16 16 16 16 16 16 8 3 7 16 16 16 16 1 1 1 16 16 1 1 1 255 227 227 227 227 227 227 227 227 227 227 255 1 16 1 1 1 1 1 16 16 16 16 1 1 1 23 18 18 18 18 18 18 18 18 18 18 
16 16 16 16 16 16 16 16 16 16 16 16 16 16 16 16 16 16 16 16 16 16 16 16 16 16 16 16 16 16 16 16 16 16 16 16 16 16 16 16 16 16 16 16 16 16 16 16 8 3 7 16 16 16 1 1 1 16 16 16 16 1 1 255 227 127 128 128 128 128 128 128 129 227 255 1 1 1 1 255 227 242 242 242 242 242 255 1 1 23 18 18 18 18 18 18 18 18 18 18 
16 16 16 16 16 16 16 16 16 16 16 16 16 16 16 16 16 16 16 16 16 16 16 16 16 16 16 16 16 16 16 16 16 16 16 16 16 16 16 16 16 16 16 16 16 16 16 16 8 3 7 16 16 16 2 1 1 16 16 16 16 1 1 255 227 135 136 136 136 136 136 136 137 227 255 1 1 1 1 255 227 227 227 227 227 227 255 1 1 23 18 18 18 18 18 18 18 18 18 18 
16 16 16 16 16 16 16 16 16 16 16 16 16 16 16 16 16 16 16 16 16 16 16 16 16 16 16 16 16 16 16 16 16 16 16 16 16 16 16 16 16 16 16 16 16 16 16 16 8 3 7 1 16 16 16 1 1 1 16 16 1 1 1 255 227 143 144 144 144 144 144 144 145 227 255 1 1 1 1 255 227 175 176 176 177 227 255 1 1 23 18 19 18 18 18 18 18 18 18 18 
16 16 16 16 16 16 16 16 16 16 16 16 16 16 16 16 16 16 16 16 16 16 16 16 16 16 16 16 16 16 16 16 16 16 16 16 16 16 16 16 16 16 16 16 16 16 16 1 8 3 7 1 16 16 16 16 1 1 1 1 1 2 1 255 227 227 227 227 227 227 227 227 227 227 255 1 1 1 1 255 227 183 184 184 185 227 255 1 1 23 18 18 18 18 18 18 18 18 18 18 
16 16 16 16 16 16 16 16 16 16 16 16 16 16 16 16 16 16 16 16 16 16 16 16 16 16 16 16 16 16 16 16 16 16 16 16 16 16 16 16 16 16 16 16 16 16 1 1 8 3 7 2 16 16 16 16 16 1 1 1 1 1 1 242 242 242 242 242 242 242 242 242 242 242 242 1 1 1 1 255 227 191 192 192 193 227 255 1 1 23 18 18 18 18 18 18 18 18 18 18 
16 16 16 16 16 16 16 16 16 16 16 16 16 16 16 16 16 16 16 16 16 16 16 16 16 16 16 16 16 16 16 16 16 16 16 16 16 16 16 16 16 16 16 16 16 1 1 1 8 3 7 1 16 16 16 16 16 16 16 16 16 1 1 1 1 1 16 16 16 16 16 1 1 1 1 2 1 1 16 255 227 227 227 227 227 227 255 1 1 23 18 18 18 18 18 18 18 18 18 18 
16 16 16 16 16 16 16 16 16 16 16 16 1 1 1 1 1 1 1 1 1 1 1 1 1 16 1 1 1 1 1 1 1 1 1 1 1 1 1 1 1 1 1 1 1 1 1 2 8 3 7 1 1 16 16 16 16 16 16 16 16 16 1 1 1 2 1 1 1 1 1 1 1 1 16 1 1 1 16 242 242 242 242 242 242 242 242 2 1 23 18 18 18 18 18 18 18 18 18 18 
1 1 16 1 1 2 1 16 16 16 16 1 1 1 1 1 1 16 1 1 1 1 1 1 1 1 1 1 1 1 1 2 1 1 1 1 1 1 2 1 1 1 16 1 1 1 1 1 8 3 7 1 1 1 1 16 16 16 16 16 16 16 1 1 1 1 1 1 1 1 1 1 1 16 16 16 1 1 1 1 1 1 1 1 1 16 1 1 1 23 18 18 18 18 18 18 18 18 18 18 
10 10 10 10 10 10 10 10 13 16 16 12 10 10 10 10 10 10 10 10 10 10 10 10 10 10 10 10 10 10 10 10 10 10 10 10 10 10 10 10 10 10 10 10 10 10 10 10 11 3 9 10 10 10 10 10 10 10 10 10 10 10 10 10 10 10 10 10 10 10 10 10 10 10 10 10 10 10 10 13 1 1 1 1 1 1 1 1 1 23 18 18 18 18 18 18 18 18 18 18 
3 3 3 3 3 3 3 3 7 16 16 8 3 3 3 3 3 3 3 3 3 3 3 3 3 3 3 3 3 3 3 3 3 3 3 3 3 3 3 3 3 3 3 3 3 3 3 3 3 3 3 3 3 3 3 3 3 3 3 3 3 3 3 3 3 3 3 3 3 3 3 3 3 3 3 3 3 3 3 7 1 16 16 16 16 1 1 1 1 23 18 18 18 18 18 18 18 18 18 18 
5 5 5 5 5 5 5 5 15 16 16 14 5 5 5 5 5 5 5 5 5 5 5 5 5 5 5 5 6 3 4 5 5 5 5 5 5 5 5 5 5 5 5 5 5 5 5 5 6 3 4 5 5 5 5 5 5 5 5 5 5 5 5 5 5 5 5 5 5 5 5 5 5 5 5 5 5 5 5 15 16 16 16 16 16 16 1 1 1 23 18 18 18 18 18 18 18 18 18 18 
1 1 1 1 16 16 16 1 16 16 16 16 1 1 1 1 2 1 1 1 1 1 1 1 1 1 1 1 8 3 7 1 1 1 1 1 1 1 1 1 1 16 1 1 1 1 1 1 8 3 7 1 2 16 1 1 1 1 1 1 1 1 1 1 1 1 1 1 1 1 1 1 1 2 1 1 1 1 1 1 16 16 16 16 16 16 16 1 1 23 18 18 18 18 18 18 18 18 18 18 
16 16 16 16 16 16 16 16 16 16 16 16 16 1 1 1 16 16 1 1 1 1 16 16 16 16 1 1 8 3 7 1 1 16 1 16 16 16 16 16 16 16 16 16 16 16 1 1 8 3 7 1 1 1 1 16 16 16 16 16 1 1 1 1 1 1 1 16 1 1 1 1 1 1 1 1 1 1 1 1 1 16 16 16 16 16 16 1 1 23 18 18 18 18 18 18 18 18 18 18 
16 16 16 16 16 16 16 16 16 16 16 16 1 1 1 16 16 16 16 16 16 16 16 16 16 16 16 1 8 3 7 1 1 16 16 16 16 16 16 16 16 16 16 16 16 16 16 1 8 3 7 1 1 16 16 16 16 16 16 16 1 1 2 1 1 1 1 1 1 1 16 1 1 1 1 1 1 1 1 1 1 1 1 1 1 1 1 2 1 23 18 18 19 18 18 18 18 18 18 18 
16 16 16 16 16 16 16 16 16 16 16 1 1 1 16 16 16 16 16 16 16 16 16 16 16 16 16 1 14 5 15 2 1 16 16 16 16 16 16 16 16 16 16 16 16 16 16 1 8 3 7 1 1 16 16 16 16 16 16 1 1 1 1 1 16 1 1 1 1 1 1 1 1 1 1 1 16 255 242 242 242 242 242 242 227 255 1 1 1 23 18 18 18 18 18 18 18 18 18 18 
16 16 16 16 16 16 16 16 16 16 16 1 2 1 16 16 1 1 1 1 1 1 1 1 1 1 1 1 1 1 1 1 1 1 1 1 1 1 1 1 1 1 1 1 16 16 16 1 8 3 7 1 16 16 16 16 16 16 1 2 1 1 1 1 1 1 1 1 16 16 16 1 1 1 1 1 255 242 227 227 227 227 227 227 227 255 1 1 1 23 18 18 18 18 18 18 18 18 18 18 
16 16 16 16 16 16 16 16 16 16 16 1 1 16 1 1 1 255 242 242 242 242 242 242 242 242 242 242 242 227 242 242 242 242 242 242 242 242 242 242 255 1 1 1 1 16 16 1 8 3 7 1 16 16 16 16 1 1 1 1 1 1 1 1 20 21 21 21 21 21 22 16 1 1 1 1 255 227 227 127 128 128 128 129 227 255 1 1 1 23 18 18 18 18 18 18 18 18 18 18 
16 16 16 16 16 16 16 16 16 16 16 1 1 1 2 255 242 242 227 227 227 227 227 227 227 227 227 227 227 227 227 227 227 227 227 227 227 227 227 227 242 242 255 1 1 16 16 1 8 3 7 1 1 1 1 1 1 1 1 1 1 1 20 21 31 18 18 18 18 19 30 22 1 1 1 1 255 227 127 169 136 151 144 145 227 255 16 1 1 23 18 18 18 18 18 18 18 18 18 18 
16 16 16 16 16 16 16 16 16 16 16 1 1 1 1 255 227 227 227 175 176 176 176 176 176 176 176 176 176 176 176 176 176 176 176 176 176 176 177 227 227 227 255 1 1 1 16 1 8 3 9 10 10 10 10 10 10 13 1 1 1 20 31 18 18 18 18 18 18 18 18 24 1 1 2 1 255 227 143 144 144 145 227 227 227 255 1 1 1 23 18 18 18 18 18 18 18 18 18 18 
16 16 16 16 16 16 16 16 16 16 16 1 1 1 255 242 227 175 176 217 184 184 184 184 184 184 184 184 184 184 184 184 184 184 184 184 184 184 215 176 177 227 242 255 1 1 1 1 8 3 3 3 3 3 3 3 3 7 1 1 1 23 18 18 19 18 18 18 18 18 18 24 1 1 1 1 255 227 227 227 227 227 227 255 242 242 1 1 1 23 18 18 18 18 18 18 18 18 18 18 
16 16 16 16 16 16 16 16 16 16 16 1 1 1 255 227 227 183 184 184 184 184 184 184 184 184 184 184 184 184 184 184 184 184 184 184 184 184 184 184 185 227 227 255 1 1 1 1 8 3 4 5 5 5 5 5 5 15 1 1 1 23 18 18 18 18 18 18 18 18 28 27 1 1 1 1 242 242 242 242 242 242 242 242 16 16 1 1 16 23 18 18 18 18 18 18 18 18 18 18 
16 16 16 16 16 16 16 16 16 16 16 1 1 1 255 227 175 217 184 184 184 184 184 184 184 184 184 184 184 184 184 184 184 184 184 184 184 184 184 184 215 177 227 255 1 1 2 1 8 3 7 1 1 16 16 1 1 1 16 1 16 25 26 29 18 18 18 18 19 28 27 1 1 1 1 1 1 1 1 1 1 1 1 1 1 1 1 1 1 23 18 18 18 18 18 18 18 18 18 18 
16 16 16 16 16 16 16 16 16 16 16 1 1 1 255 227 183 184 184 184 184 184 184 184 184 184 184 184 184 184 184 184 184 184 184 184 184 184 184 184 184 185 227 255 16 1 1 1 8 3 7 1 16 16 16 1 1 1 1 1 1 16 16 25 29 18 18 28 26 27 16 1 1 1 1 16 1 1 1 1 1 1 1 1 1 1 1 1 1 23 18 18 18 18 18 18 18 18 18 18 
16 16 16 16 16 16 16 16 16 16 16 1 1 1 255 227 183 184 184 184 184 184 184 184 184 184 184 184 184 184 184 184 184 184 184 184 184 184 184 184 184 185 227 255 16 1 1 1 8 3 7 1 16 1 1 1 2 1 1 1 1 1 16 16 25 26 26 27 16 16 1 1 1 16 16 16 16 16 1 1 255 242 242 242 242 242 242 255 1 23 18 18 18 18 18 18 18 18 18 18 
16 16 16 16 16 16 16 16 16 16 16 1 1 1 255 227 183 184 184 184 184 184 184 184 184 184 184 184 184 184 184 184 184 184 184 184 184 184 184 184 184 185 227 255 1 1 1 1 8 3 7 1 1 1 1 1 1 1 1 1 1 1 1 1 1 1 1 1 1 1 1 1 1 1 1 1 16 1 1 1 255 227 227 227 227 227 227 255 1 23 18 18 18 18 18 18 18 19 18 18 
16 16 16 16 16 16 16 16 16 16 16 1 2 1 255 227 183 184 184 184 184 184 184 184 184 184 184 184 184 184 184 184 184 184 184 184 184 184 184 184 184 185 227 255 1 1 16 1 8 3 7 1 1 1 16 1 1 16 16 16 16 1 1 1 1 1 1 1 1 1 1 1 1 1 1 1 1 1 1 1 255 227 123 109 80 81 227 255 1 23 18 18 18 18 18 18 18 18 18 18 
16 16 16 16 16 16 16 16 16 16 16 1 1 1 255 227 183 184 184 184 184 184 184 184 184 184 184 184 184 184 184 184 184 184 184 184 184 184 184 184 184 185 227 255 1 1 1 1 8 3 7 1 2 1 1 1 16 16 255 242 242 242 242 227 242 255 1 1 1 255 242 227 242 255 16 16 1 1 1 16 255 227 227 87 88 89 227 255 1 23 18 18 18 18 18 18 18 18 18 18 
16 16 16 16 16 16 16 16 16 16 16 1 1 1 255 227 183 184 184 184 184 184 184 184 184 184 184 184 184 184 184 184 184 184 184 184 184 184 184 184 184 185 227 255 1 2 1 1 8 3 7 1 1 1 1 1 16 16 255 227 227 227 227 227 227 255 16 1 16 255 227 227 227 242 242 242 255 16 1 1 242 255 227 87 88 89 227 255 1 23 18 18 18 18 18 18 18 18 18 18 
16 16 16 16 16 16 16 16 16 16 16 1 1 1 255 227 191 201 184 184 184 184 184 184 184 184 184 184 184 184 184 184 184 184 184 184 184 184 184 184 199 193 227 255 1 1 1 1 8 3 7 1 16 1 1 1 16 16 255 227 127 128 128 129 227 255 16 1 16 255 227 202 227 227 227 227 242 255 16 1 1 255 227 95 104 97 227 255 1 23 18 18 18 18 18 18 18 18 18 18 
16 16 16 16 16 16 16 16 16 16 16 1 1 1 255 227 227 183 184 184 184 184 184 184 184 184 184 184 184 184 184 184 184 184 184 184 184 184 184 184 185 227 227 255 1 1 16 1 8 3 7 1 16 16 16 1 1 16 255 227 143 144 144 145 227 255 16 1 16 255 227 194 220 220 221 227 227 255 16 1 1 255 227 227 122 227 227 255 1 23 18 18 18 18 18 18 18 18 18 18 
16 16 16 16 16 16 16 16 16 16 16 1 1 1 242 255 227 191 192 201 184 184 184 184 184 184 184 184 184 184 184 184 184 184 184 184 184 184 199 192 193 227 255 242 1 16 16 1 8 3 7 1 16 16 16 16 1 16 255 227 227 227 227 227 227 255 16 1 16 255 227 227 227 227 227 227 227 255 16 1 1 242 255 227 227 227 255 242 1 23 18 18 18 18 18 18 18 18 18 18 
16 16 16 16 16 16 16 16 16 16 16 1 1 1 1 255 227 227 227 191 192 192 192 192 192 192 192 192 192 192 192 192 192 192 192 192 192 192 193 227 227 227 255 1 1 16 16 1 8 3 7 1 16 16 16 16 1 16 242 242 242 242 242 242 242 242 16 1 16 242 242 242 242 242 242 242 242 242 16 1 1 16 242 242 227 242 242 16 1 23 18 18 18 18 18 18 18 18 18 18 
16 16 16 16 16 16 16 16 16 16 16 1 1 16 2 242 242 255 227 227 227 227 227 227 227 227 227 227 227 227 227 227 227 227 227 227 227 227 227 227 255 242 242 1 16 16 16 1 8 3 7 1 16 16 16 16 1 1 1 1 1 1 1 1 1 1 1 1 1 16 16 16 16 16 16 16 16 16 1 1 1 1 16 16 1 16 16 1 1 23 18 18 18 18 18 18 18 18 18 18 
16 16 16 16 16 16 16 16 16 16 16 1 16 16 1 1 1 242 242 242 242 242 242 242 242 242 242 242 242 227 242 242 242 242 242 242 242 242 242 242 242 1 1 1 16 16 1 1 8 3 7 1 16 16 16 16 16 16 16 16 16 16 16 16 16 16 16 1 1 1 1 2 1 1 1 1 1 1 1 1 1 1 1 1 1 1 1 1 1 23 18 18 18 18 18 18 18 18 18 18 
16 16 16 16 16 16 16 16 16 16 16 1 16 16 16 1 1 1 1 1 1 1 1 1 1 1 1 1 1 1 1 1 1 1 1 1 1 1 1 1 1 1 1 1 1 1 1 1 8 3 7 1 16 16 16 16 16 16 16 16 16 16 16 16 16 16 16 16 16 16 16 16 16 16 16 16 16 16 16 16 16 16 1 2 1 1 1 2 1 23 18 19 18 18 18 18 18 18 18 18 
16 16 16 16 16 16 16 16 16 16 16 1 16 16 1 1 1 1 1 1 1 2 1 1 1 1 1 1 1 1 1 2 1 1 1 1 1 1 1 1 1 1 1 1 1 1 1 1 8 3 7 1 16 16 16 16 16 16 16 16 16 16 16 16 16 16 16 16 16 16 16 16 16 16 16 16 16 16 16 16 16 16 16 1 1 1 1 1 16 23 18 18 18 18 18 18 18 18 18 18 
16 16 16 16 16 16 16 16 16 16 16 1 16 1 1 1 16 16 16 16 16 16 16 16 16 16 16 1 1 1 1 1 16 16 16 16 16 16 1 16 16 16 16 16 1 1 16 1 8 3 7 1 16 16 16 16 16 16 16 16 16 16 16 16 16 16 16 16 16 16 16 16 16 16 16 16 16 16 16 16 16 16 16 16 16 16 1 1 16 23 18 18 18 18 18 18 18 18 19 18 
16 16 16 16 16 16 16 16 16 16 16 1 1 1 16 16 16 16 16 16 16 16 16 16 16 16 16 16 1 1 1 16 16 16 16 16 16 16 16 16 16 16 16 16 16 1 1 16 8 3 7 1 16 16 16 16 16 16 16 16 16 16 16 16 16 16 16 16 16 16 16 16 16 16 16 16 16 16 16 16 16 16 16 16 16 16 16 1 16 23 18 18 18 18 18 18 18 18 18 18 
16 16 16 16 16 16 16 16 16 16 16 1 1 16 16 16 16 16 16 16 16 16 16 16 16 16 16 16 16 1 16 16 16 16 16 16 16 16 16 16 16 16 16 16 16 16 1 16 8 3 7 1 16 16 16 16 16 16 16 16 16 16 16 16 16 16 16 16 16 16 16 16 16 16 16 16 16 16 1 1 1 1 1 1 1 16 16 1 2 23 18 18 18 18 18 18 18 18 18 18 
16 16 16 16 16 16 16 16 16 16 16 1 16 16 16 16 16 16 16 16 16 16 16 16 16 16 16 16 1 1 1 16 16 16 16 16 16 16 16 16 16 16 16 16 16 16 1 1 8 3 7 1 16 16 16 16 16 16 16 1 1 1 1 1 1 1 1 1 2 1 1 1 1 1 1 1 1 1 1 257 251 251 251 257 1 16 16 16 1 23 18 18 18 18 18 18 18 18 18 18 
16 16 16 16 16 16 16 16 16 16 16 1 16 16 16 16 16 16 16 16 16 16 16 16 16 16 16 1 1 1 1 1 16 16 16 16 16 16 16 16 16 16 16 16 16 16 1 1 8 3 7 1 16 16 16 16 16 16 1 1 2 1 1 1 1 16 16 16 16 16 16 16 16 16 16 16 1 1 1 257 34 34 34 257 1 16 16 16 16 23 18 18 18 18 18 18 18 18 18 18 
16 16 16 16 16 16 16 16 16 16 16 1 16 16 16 16 16 16 16 16 16 16 16 16 16 16 1 2 1 1 1 1 1 16 16 16 16 16 16 16 16 16 16 16 16 16 16 1 8 3 7 1 16 16 16 16 16 1 1 1 1 1 1 1 16 16 16 16 16 16 16 16 16 16 16 16 16 1 1 257 34 35 34 257 1 16 16 16 16 23 18 18 18 18 18 18 18 18 18 18 
16 16 16 16 16 16 16 16 16 16 16 1 1 16 16 16 16 16 16 16 16 16 16 16 16 16 1 1 1 1 1 1 1 2 16 16 16 16 16 16 16 16 16 16 16 16 16 1 8 3 7 1 16 16 16 16 16 1 1 1 1 1 1 1 16 16 16 16 16 16 16 16 16 16 16 16 16 1 2 257 34 34 34 257 1 16 16 16 16 23 18 18 18 18 18 18 18 18 18 18 
16 16 16 16 16 16 16 16 16 16 16 1 1 1 16 1 1 1 1 1 1 1 16 16 16 1 1 1 1 1 1 1 1 1 16 16 16 16 16 16 16 16 16 16 16 16 16 1 14 5 15 1 16 16 16 16 16 1 16 1 1 1 1 1 16 16 16 16 16 16 16 16 16 16 16 16 16 16 1 251 251 34 251 251 1 16 16 16 16 23 18 18 18 18 18 18 18 18 18 18 
16 16 16 16 16 16 16 16 16 16 16 1 1 1 2 1 1 1 1 1 1 1 1 16 1 1 1 1 1 2 1 1 1 16 16 16 16 16 16 16 16 16 16 16 16 16 16 1 1 1 1 1 16 16 16 16 16 16 2 1 1 1 1 1 1 16 16 16 16 16 16 16 16 16 16 16 16 16 1 1 1 1 1 1 1 16 16 16 16 23 18 18 18 18 18 18 18 18 18 18 
16 16 16 16 16 16 16 16 16 16 16 1 1 1 1 1 16 16 16 1 1 1 1 1 1 1 1 1 1 1 1 1 16 1 1 1 1 1 1 1 1 1 1 16 16 16 16 1 1 1 1 1 16 16 16 16 16 16 16 1 1 1 1 1 2 1 16 16 16 16 16 16 16 16 16 16 16 16 16 16 16 16 16 16 16 16 16 16 16 23 18 18 18 18 18 18 18 18 18 18 
16 16 16 16 16 16 16 16 16 16 16 1 1 1 1 16 16 16 1 2 1 1 1 1 1 16 16 1 1 1 1 1 1 1 1 1 1 1 1 1 1 1 1 1 16 16 16 1 1 1 1 1 16 16 16 16 16 16 16 16 16 16 16 16 1 1 1 1 16 16 16 16 16 16 16 16 16 16 16 16 16 16 16 16 16 16 16 16 16 23 18 18 18 18 18 18 19 18 18 18 
16 16 16 16 16 16 16 16 16 16 16 16 16 16 16 16 16 1 1 1 1 1 1 1 1 1 16 16 16 16 1 1 1 1 1 16 16 16 16 16 16 16 1 1 1 16 16 1 1 1 2 1 16 16 16 16 16 16 16 16 16 16 16 16 16 1 1 1 1 1 1 1 1 1 1 1 1 1 1 1 16 16 16 16 1 16 16 16 16 23 18 18 18 18 18 18 18 18 18 18 
16 16 16 16 16 16 16 16 16 16 16 16 16 16 16 16 16 16 16 16 1 16 1 1 1 1 1 16 16 16 16 1 1 1 1 1 16 16 16 16 16 16 16 1 1 16 1 1 1 1 1 1 16 16 16 16 16 16 16 16 16 16 16 16 16 16 16 16 16 16 16 16 16 16 1 1 1 1 1 1 1 1 1 1 1 1 16 16 1 23 18 18 18 18 18 18 18 18 18 18 
16 16 16 16 16 16 16 16 16 16 16 16 16 16 16 16 16 16 16 16 16 16 16 16 1 1 1 1 16 16 16 16 1 1 1 1 1 1 16 16 16 16 16 16 1 1 2 1 1 1 1 1 16 16 16 16 16 16 16 16 16 16 16 16 16 16 16 16 16 16 16 16 16 1 1 1 1 1 1 1 1 1 1 1 1 1 1 1 1 23 18 18 18 18 18 18 18 18 18 18 
16 16 16 16 16 16 16 16 16 16 16 16 2 1 1 16 16 16 16 16 16 16 16 16 16 16 2 1 1 1 1 1 1 1 1 1 1 1 1 1 1 1 16 1 1 1 1 1 1 1 1 1 1 16 16 16 16 16 16 16 16 16 16 16 16 16 16 16 16 16 16 1 1 1 1 1 1 1 1 1 2 2 1 1 1 1 1 1 1 23 18 18 18 18 18 18 18 18 18 18 
16 16 16 16 16 16 16 16 16 16 257 251 227 257 1 16 16 16 16 16 16 16 16 16 16 16 16 1 1 1 1 1 1 1 1 1 2 1 1 1 1 1 1 1 1 1 16 16 1 1 1 1 1 16 16 16 16 16 16 16 16 16 16 16 16 16 16 16 16 1 1 2 1 1 1 1 16 1 1 1 1 1 1 1 1 1 1 2 1 23 18 18 18 18 18 18 18 18 18 18 
16 16 16 16 16 16 16 16 16 16 257 227 227 257 1 16 16 16 16 16 2 1 1 16 16 16 16 16 1 1 1 1 1 1 1 1 1 1 16 16 16 16 16 16 16 16 16 16 16 1 1 1 1 2 16 16 16 16 16 16 16 16 16 16 16 16 16 1 1 1 1 1 1 1 16 16 16 16 1 1 1 1 1 16 16 1 1 1 1 23 18 18 18 18 18 18 18 18 18 18 
16 16 16 16 16 16 16 16 16 16 257 227 227 257 1 1 1 1 1 1 1 16 1 1 1 1 1 1 1 16 16 16 16 16 1 1 1 1 1 1 16 16 16 16 16 16 16 16 16 16 1 1 1 1 1 1 1 1 1 1 1 1 1 2 1 1 1 1 1 1 1 1 1 1 1 1 1 1 1 1 16 16 16 1 1 1 1 16 1 23 18 18 18 18 18 18 18 18 18 18 
16 16 16 16 16 16 16 16 16 16 251 251 250 251 16 16 16 16 16 16 16 16 16 16 16 16 16 16 16 16 16 16 16 16 16 16 16 16 16 16 16 16 16 16 16 16 16 16 16 16 16 16 16 16 16 16 16 16 16 16 16 16 16 16 16 16 16 16 16 16 16 16 16 16 16 16 16 16 16 16 16 16 16 16 16 16 16 16 16 23 18 18 18 18 18 18 18 18 18 18 
16 16 16 16 16 16 16 16 16 16 16 16 16 16 16 16 16 16 16 16 16 16 16 16 16 16 16 16 16 16 16 16 16 16 16 16 16 16 16 16 16 16 16 16 16 16 16 16 16 16 16 16 16 16 16 16 16 16 16 16 16 16 16 16 16 16 16 16 16 16 16 16 16 16 16 16 16 16 16 16 16 16 16 16 16 16 16 16 16 23 18 18 18 18 18 18 18 18 18 18 
16 16 16 16 16 16 16 16 16 16 16 16 16 16 16 16 16 16 16 16 16 16 16 16 16 16 16 16 16 16 16 16 16 16 16 16 16 16 16 16 16 16 16 16 16 16 16 16 16 16 16 16 16 16 16 16 16 16 16 16 16 16 16 16 16 16 16 16 16 16 16 16 16 16 16 16 16 16 16 16 16 16 16 16 16 16 16 16 16 23 18 18 19 18 18 18 18 18 18 18 
16 16 16 16 16 16 16 16 16 16 16 16 16 16 16 16 16 16 16 16 16 16 16 16 16 16 16 16 16 16 16 16 16 16 16 16 16 16 16 16 16 16 16 16 16 16 16 16 16 16 16 16 16 16 16 16 16 16 16 16 16 16 16 16 16 16 16 16 16 16 16 16 16 16 16 16 16 16 16 16 16 16 16 16 16 16 16 16 16 23 18 18 18 18 18 18 18 18 18 18 
16 16 16 16 16 16 16 16 16 16 16 16 16 16 16 16 16 16 16 16 16 16 16 16 16 16 16 16 16 16 16 16 16 16 16 16 16 16 16 16 16 16 16 16 16 16 16 16 16 16 16 16 16 16 16 16 16 16 16 16 16 16 16 16 16 16 16 16 16 16 16 16 16 16 16 16 16 16 16 16 16 16 16 16 16 16 16 16 16 23 18 18 18 18 18 18 18 18 18 18 
16 16 16 16 16 16 16 16 16 16 16 16 16 16 16 16 16 16 16 16 16 16 16 16 16 16 16 16 16 16 16 16 16 16 16 16 16 16 16 16 16 16 16 16 16 16 16 16 16 16 16 16 16 16 16 16 16 16 16 16 16 16 16 16 16 16 16 16 16 16 16 16 16 16 16 16 16 16 16 16 16 16 16 16 16 16 16 16 16 23 18 18 18 18 18 18 18 18 18 18 
