16 16 16 16 16 16 16 16 16 16 16 16 16 16 16 16 16 16 16 16 16 16 16 16 16 16 16 16 16 16 16 16 16 16 16 16 16 16 16 16 16 16 16 16 16 16 16 16 16 16 16 16 16 16 16 16 16 16 16 16 16 16 16 16 16 16 16 16 16 16 16 16 16 16 16 16 16 16 16 16 16 16 16 16 16 16 16 16 16 23 18 18 18 18 18 19 18 18 18 18 
16 16 16 16 16 16 16 16 16 16 16 16 16 16 16 16 16 16 16 16 16 16 16 16 16 16 16 16 16 16 16 16 16 16 16 16 16 16 16 16 16 16 16 16 16 16 16 16 16 16 16 16 16 16 16 16 16 16 16 16 16 16 16 16 16 16 16 16 16 16 16 16 16 16 16 16 16 16 16 16 16 16 16 16 16 16 16 16 16 23 18 18 18 18 18 18 18 18 18 18 
16 16 16 16 16 16 16 16 16 16 16 16 16 16 16 16 16 16 16 16 16 16 16 16 16 16 16 16 16 16 16 16 16 16 16 16 16 16 16 16 16 16 16 16 16 16 16 16 16 16 16 16 16 16 16 16 16 16 16 16 16 16 16 16 16 16 16 16 16 16 16 16 16 16 16 16 16 16 16 16 16 16 16 16 16 16 16 16 16 23 18 18 18 28 26 26 26 29 18 18 
16 16 16 16 16 16 16 16 16 16 16 16 16 16 16 16 16 16 16 16 16 16 16 16 16 16 16 16 16 16 16 16 16 16 16 16 16 16 16 16 16 16 16 16 16 16 16 16 16 16 16 16 16 16 16 16 16 16 16 16 16 16 16 16 16 16 16 16 16 16 16 16 16 16 16 16 16 16 16 16 16 16 16 16 16 16 16 16 16 23 18 18 28 27 1 1 1 23 18 18 
16 16 16 16 16 16 16 16 16 16 16 16 16 16 16 16 16 16 16 16 16 16 16 16 16 16 16 16 16 16 16 16 16 16 16 16 16 16 16 16 16 16 16 16 16 16 16 16 16 16 16 16 16 16 16 16 16 16 16 16 16 16 16 16 16 16 16 16 16 16 16 16 16 16 16 16 16 16 16 16 16 16 16 16 16 16 16 16 16 23 18 18 24 1 1 1 1 23 18 18 
16 16 16 16 16 16 16 16 16 16 16 16 16 16 16 16 16 16 16 16 16 16 16 16 16 16 16 16 16 16 16 16 16 16 16 16 16 16 16 16 16 16 16 16 16 16 16 16 16 16 16 16 16 16 16 16 16 16 16 16 16 16 16 16 16 16 16 16 16 16 16 16 16 16 16 16 16 16 16 16 16 16 16 16 16 16 16 16 16 23 18 18 24 1 1 1 1 23 18 18 
16 16 16 16 16 16 16 16 16 16 16 1 1 1 1 1 32 32 32 32 32 32 32 32 1 1 1 1 1 1 1 1 1 1 1 1 1 1 2 1 1 1 1 1 1 1 1 1 1 1 1 1 1 1 1 2 1 1 1 1 1 1 1 1 1 1 1 1 1 1 1 1 1 1 2 1 1 1 1 1 1 16 16 16 16 16 16 16 16 23 18 18 30 21 21 21 21 31 18 18 
16 16 16 16 16 16 16 16 16 16 16 1 2 1 16 1 32 127 128 128 128 128 129 32 1 16 16 16 16 16 16 16 16 16 16 16 16 16 16 16 16 16 16 1 1 1 1 1 16 16 16 16 16 1 1 1 1 1 1 1 1 32 32 32 32 32 32 32 32 32 32 1 1 1 1 1 1 16 16 16 1 1 1 1 1 16 16 16 16 23 18 18 18 18 18 18 18 18 18 19 
16 16 16 16 16 16 16 16 16 16 16 1 1 1 1 1 32 135 136 136 136 136 137 32 1 1 16 16 16 16 16 16 16 16 16 16 16 16 16 16 16 16 16 16 1 1 2 16 16 16 16 16 16 1 1 1 1 1 16 16 1 32 79 80 80 80 80 80 80 81 32 32 32 1 1 1 16 16 16 16 16 16 1 1 1 16 16 16 16 23 18 18 18 18 18 18 18 18 18 18 
16 16 16 16 16 16 16 16 16 16 16 2 1 1 1 1 32 135 136 136 136 136 137 32 1 1 16 16 16 16 16 16 16 16 16 16 16 16 16 16 16 16 16 16 1 1 16 16 16 16 16 16 16 16 1 1 1 16 16 16 1 32 87 88 88 88 88 88 88 119 80 81 32 1 1 1 1 1 1 16 16 16 16 1 1 1 16 16 16 23 18 18 18 18 18 18 18 18 18 18 
16 16 16 16 16 16 16 16 16 16 16 32 32 223 32 32 32 135 136 136 136 136 137 32 1 1 1 16 16 16 16 16 16 16 1 1 1 1 16 16 16 16 16 16 1 1 16 16 16 16 16 16 16 16 16 1 1 16 16 16 1 32 87 88 88 88 88 88 88 88 88 89 32 1 16 1 1 1 1 1 1 1 1 1 1 1 16 16 16 23 18 18 18 18 18 18 18 18 18 18 
16 16 16 16 16 16 16 16 16 16 16 32 127 136 128 128 128 169 136 136 136 136 137 32 1 1 2 1 16 16 16 16 16 1 1 1 16 1 1 16 16 16 16 16 1 1 16 16 16 16 16 16 16 16 1 1 16 16 16 16 1 32 87 88 88 88 88 88 88 88 88 89 32 1 16 1 32 32 32 32 32 32 32 32 1 1 1 16 1 23 18 18 18 18 18 18 18 18 18 18 
16 16 16 16 16 16 16 16 16 16 16 32 135 136 136 136 136 136 136 136 136 136 136 223 1 1 1 1 1 1 1 1 1 1 1 1 1 1 1 1 16 16 16 16 1 1 1 16 16 16 16 16 16 16 1 1 16 16 16 1 1 32 95 88 96 96 96 105 88 88 88 89 32 1 16 1 32 175 176 176 176 176 177 32 1 1 1 1 1 23 18 18 18 18 18 18 18 18 18 18 
16 16 16 16 16 16 16 16 16 16 16 32 143 144 144 144 144 144 144 144 144 144 145 32 1 1 1 1 16 16 16 1 1 1 1 1 2 1 1 1 16 16 16 16 1 1 1 16 16 16 16 16 16 16 1 2 1 1 1 1 1 32 32 223 32 32 32 95 96 96 96 97 32 1 1 1 32 183 184 184 184 184 185 32 1 1 1 1 1 23 18 18 18 18 18 18 18 18 18 18 
16 16 16 16 16 16 16 16 16 16 16 32 32 32 32 32 32 32 32 32 32 32 32 32 1 1 1 16 16 16 16 1 1 16 16 1 1 1 1 1 16 16 16 16 16 1 1 1 1 1 16 16 16 1 1 1 1 1 1 1 1 1 1 1 1 1 32 32 32 32 32 32 32 1 1 1 32 183 184 184 184 184 185 32 1 1 16 1 1 23 18 18 18 18 18 18 18 18 18 18 
16 16 16 16 16 16 16 16 16 16 16 1 2 1 1 1 1 1 1 1 1 1 1 1 1 1 16 16 16 16 16 16 2 1 16 1 1 16 1 1 1 16 16 16 16 16 2 1 1 1 1 1 1 1 1 16 16 16 16 1 1 1 1 1 1 1 1 1 1 1 1 1 1 1 1 1 32 183 184 184 184 184 185 32 1 1 1 1 1 23 18 18 18 18 18 18 18 18 18 18 
16 16 16 16 16 16 16 16 16 16 16 1 16 16 16 1 1 1 16 16 16 16 16 16 16 16 16 16 16 16 16 16 1 1 1 1 1 1 16 16 1 16 16 16 16 16 16 16 1 1 1 1 1 1 16 1 16 16 16 16 1 1 1 1 1 1 1 1 1 1 1 16 1 1 1 32 32 183 184 184 184 184 185 32 1 1 1 2 1 23 19 18 18 18 18 18 18 18 18 18 
16 16 16 16 16 16 16 16 16 16 16 16 16 16 1 1 1 16 16 16 16 16 16 16 16 16 16 16 16 16 16 16 16 16 16 16 16 16 16 16 1 16 16 16 16 16 16 16 12 10 13 1 1 1 32 32 32 32 32 32 32 32 32 32 32 1 1 1 2 1 1 1 1 16 16 32 175 217 184 184 184 184 185 32 32 1 1 2 1 23 18 18 18 18 18 18 18 18 18 18 
16 16 16 16 16 16 16 16 16 16 16 16 16 16 1 1 1 16 16 16 16 16 16 16 16 16 16 16 16 16 16 16 16 16 16 16 16 16 16 16 1 16 16 16 16 16 16 16 8 3 7 1 1 1 32 127 128 128 128 128 128 128 128 129 32 32 1 1 1 1 1 1 1 16 16 32 183 184 184 184 184 184 215 177 32 1 1 1 1 23 18 18 18 18 18 18 18 18 18 18 
16 16 16 16 16 16 16 16 16 16 16 16 16 1 1 2 1 16 16 16 16 16 16 16 16 16 16 16 16 16 16 16 16 16 16 16 16 16 16 16 1 1 16 16 16 16 1 16 8 3 7 1 1 1 32 135 136 136 136 136 136 136 136 136 129 32 1 1 1 1 1 1 1 16 16 32 183 184 184 184 184 184 184 185 32 1 1 1 16 23 18 18 18 18 18 18 18 18 18 18 
16 16 16 16 16 16 16 16 16 16 16 16 1 1 1 1 1 1 16 16 16 16 16 16 1 1 1 1 1 1 16 16 16 16 16 16 16 16 16 16 16 1 16 16 16 16 16 2 8 3 7 1 1 1 32 135 136 136 136 136 136 136 136 136 137 32 1 16 1 1 1 1 1 16 16 32 183 184 184 184 184 184 184 185 32 1 1 1 1 23 18 18 18 18 18 18 18 18 18 18 
16 16 16 16 16 16 16 16 16 16 16 16 1 1 1 1 1 1 1 1 1 1 1 1 1 1 1 1 1 1 1 1 1 1 1 1 1 16 16 16 16 1 16 16 16 16 16 1 8 3 7 1 1 16 32 135 136 136 136 136 136 136 136 136 136 223 1 16 1 1 1 2 1 1 1 32 183 184 184 184 184 184 184 185 32 1 1 1 1 23 18 18 18 18 18 18 18 18 18 18 
16 16 16 16 16 16 16 16 16 16 16 1 2 1 1 1 16 1 1 1 1 1 1 1 1 16 1 1 1 1 1 1 1 1 16 1 1 1 1 1 1 1 1 16 16 16 16 16 8 3 7 1 1 16 32 143 144 144 144 144 144 144 144 144 145 32 1 16 12 10 13 1 1 1 1 223 184 184 184 184 184 184 184 185 32 1 1 1 1 23 18 18 18 18 18 19 18 18 18 18 
16 16 16 16 16 16 16 16 16 16 16 1 1 1 1 16 16 16 16 1 1 1 1 1 1 1 16 1 1 1 1 2 1 1 1 1 1 1 1 16 1 1 1 16 16 16 16 16 8 3 7 1 1 1 32 32 32 32 32 32 32 32 32 32 32 32 1 1 8 3 7 1 1 1 1 32 183 184 184 184 184 184 184 185 32 32 1 1 1 23 18 18 18 18 18 18 18 18 18 18 
16 16 16 16 16 16 16 16 16 16 16 1 1 1 1 16 16 16 16 1 1 1 16 16 1 1 1 1 1 1 1 1 1 1 1 1 1 1 1 1 1 1 1 1 16 16 16 16 8 3 7 1 1 1 1 1 1 1 1 1 1 1 1 1 1 1 1 12 11 3 7 1 1 1 1 32 183 184 184 184 184 184 184 215 177 32 1 1 1 23 18 18 18 18 18 18 18 18 18 18 
16 16 16 16 16 16 16 16 16 16 16 1 1 1 1 16 16 16 1 1 1 1 16 16 1 1 1 1 1 1 1 1 1 1 1 1 1 1 1 1 1 1 16 1 16 16 16 16 8 3 7 1 1 1 1 1 1 1 1 1 1 1 2 1 1 1 1 8 3 3 7 1 1 1 1 32 191 192 192 192 192 192 192 192 193 32 1 1 1 23 18 18 18 18 18 18 18 18 18 18 
16 16 16 16 16 16 16 16 16 16 16 1 1 1 16 16 16 1 1 1 16 16 16 16 16 16 1 1 1 1 1 1 1 1 1 1 1 1 1 1 2 1 1 1 16 16 16 16 8 3 7 1 1 2 32 32 32 32 32 32 32 1 1 16 1 1 1 14 6 3 7 1 1 1 1 32 32 32 32 32 32 32 32 32 32 32 1 1 1 23 18 18 18 18 18 18 18 18 18 18 
16 16 16 16 16 16 16 16 16 16 16 1 1 1 16 16 16 1 2 1 16 16 16 16 16 16 16 1 1 1 1 1 1 1 1 1 1 1 1 1 1 1 1 1 16 16 16 16 8 3 7 1 1 16 32 79 80 80 80 81 32 32 1 1 1 1 1 1 8 3 9 10 13 1 1 1 1 1 1 1 1 1 1 16 16 16 1 1 1 23 18 18 18 18 18 18 18 18 18 18 
16 16 16 16 16 16 16 16 16 16 16 1 1 1 16 16 16 1 1 1 16 16 16 16 16 16 16 16 1 2 1 1 1 1 1 1 1 1 1 1 1 1 1 1 16 16 16 16 8 3 7 1 1 16 32 87 88 88 88 119 81 32 16 1 1 1 1 1 8 3 3 3 7 1 2 1 1 1 1 1 1 1 1 1 1 1 1 1 1 23 18 18 18 18 18 18 18 18 18 18 
16 16 16 16 16 16 16 16 16 16 16 1 1 1 16 16 1 2 1 16 16 16 16 16 16 16 16 16 1 1 16 16 1 1 2 1 1 1 1 1 1 1 1 1 16 16 16 16 8 3 7 1 16 1 32 87 88 88 88 88 89 32 16 16 1 1 1 1 8 3 4 5 15 1 1 1 1 1 1 1 1 1 1 1 1 1 1 1 1 23 18 18 18 18 18 18 18 18 19 18 
16 16 16 16 16 16 16 16 16 16 16 1 2 1 1 1 1 1 1 1 16 16 16 16 16 16 16 16 1 1 16 16 16 1 1 1 16 16 16 16 16 1 2 1 16 16 16 16 8 3 7 1 1 1 32 87 88 88 88 88 89 32 16 16 1 1 1 1 8 3 7 1 1 1 1 1 1 16 32 32 32 32 32 32 32 32 32 1 1 23 18 18 18 18 18 18 18 18 18 18 
16 16 16 16 16 16 16 16 16 16 16 1 1 1 1 1 1 1 1 1 16 16 16 16 16 16 16 16 1 1 16 16 1 1 1 16 16 16 16 16 16 16 1 1 16 16 16 16 8 3 7 1 1 1 32 87 88 88 88 88 89 32 16 16 1 1 1 1 8 3 7 1 1 1 1 1 16 16 32 79 80 80 80 80 80 81 32 1 1 23 18 18 18 18 18 18 18 18 18 18 
16 16 16 16 16 16 16 16 16 16 16 16 1 1 1 16 16 16 1 1 1 16 16 16 16 16 16 16 1 1 1 1 1 1 16 16 16 16 16 16 16 16 1 1 16 16 16 16 8 3 7 2 1 1 32 87 88 88 88 88 89 32 16 16 1 1 1 1 8 3 7 1 1 1 1 16 16 32 32 87 88 88 88 88 88 89 32 1 1 23 18 18 18 18 18 18 18 18 18 18 
16 16 16 16 16 16 16 16 16 16 16 16 1 1 1 1 16 16 16 1 1 16 16 16 16 16 1 1 1 1 1 1 1 16 16 16 16 16 16 16 16 1 1 16 16 16 16 16 8 3 7 1 1 16 32 87 88 88 88 88 89 32 16 1 1 1 1 1 14 5 15 1 1 1 1 16 16 32 79 121 88 88 88 88 88 89 32 1 1 23 18 18 18 18 18 18 18 18 18 18 
16 16 16 16 16 16 16 16 16 16 16 16 16 1 1 1 1 16 16 1 1 1 1 1 1 1 2 1 1 1 1 1 16 16 16 16 16 16 16 16 1 1 1 16 16 16 16 16 8 3 7 1 1 16 32 95 88 96 96 96 97 32 1 1 1 1 1 1 1 1 1 1 1 1 1 1 16 32 87 88 88 88 88 88 103 97 32 1 1 23 18 18 18 18 18 18 18 18 18 18 
16 16 16 16 16 16 16 16 16 16 16 16 16 16 1 1 1 1 16 1 1 1 1 1 1 1 1 1 16 16 1 1 1 16 16 16 16 1 1 2 1 1 16 16 16 16 16 16 8 3 7 1 1 1 32 32 223 32 32 32 32 32 1 1 1 1 1 2 1 1 1 1 1 1 1 1 1 32 95 88 96 96 96 96 97 32 32 1 1 23 18 18 18 18 18 18 18 18 18 18 
16 16 16 16 16 16 16 16 16 16 16 16 16 16 16 1 1 1 1 1 1 16 16 16 16 16 16 16 16 16 16 1 1 1 1 1 1 1 1 1 1 16 16 16 16 16 16 16 8 3 7 1 1 1 1 1 1 1 16 16 1 1 1 1 1 16 16 1 1 1 1 1 16 16 1 1 1 32 32 223 32 32 32 32 32 32 1 1 1 23 18 18 18 18 18 18 18 18 19 18 
16 16 16 16 16 16 16 16 16 16 16 16 16 16 16 16 16 1 1 1 1 1 1 2 1 1 1 1 1 1 1 1 1 1 1 1 1 1 1 16 16 16 16 16 16 16 16 16 8 3 7 1 1 1 1 1 1 1 1 1 1 1 1 1 16 16 16 16 1 1 1 1 16 16 16 1 1 1 1 1 1 1 1 1 1 1 1 1 16 23 18 18 18 18 18 18 18 18 18 18 
16 16 16 16 16 16 16 16 16 16 16 16 16 16 16 16 16 16 16 16 16 16 16 16 16 16 16 16 16 16 16 16 16 16 16 16 16 16 16 16 16 16 16 16 16 16 16 16 8 3 7 1 16 16 16 1 1 1 1 1 1 1 1 32 32 32 32 32 32 32 32 223 32 32 32 1 1 1 1 1 1 1 1 1 1 1 1 1 1 23 18 18 18 18 18 18 18 18 18 18 
16 16 16 16 16 16 16 16 16 16 16 16 16 16 16 16 16 16 16 16 16 16 16 16 16 16 16 16 16 16 16 16 16 16 16 16 16 16 16 16 16 16 16 16 16 16 16 16 8 3 7 16 16 16 16 1 1 1 16 16 1 1 1 32 127 128 128 128 128 128 128 136 128 129 32 1 16 1 1 1 1 1 16 16 16 16 1 1 1 23 18 18 18 18 18 18 18 18 18 18 
16 16 16 16 16 16 16 16 16 16 16 16 16 16 16 16 16 16 16 16 16 16 16 16 16 16 16 16 16 16 16 16 16 16 16 16 16 16 16 16 16 16 16 16 16 16 16 16 8 3 7 16 16 16 1 1 1 16 16 16 16 1 1 32 135 136 136 136 136 136 136 136 136 137 32 1 1 1 1 32 32 32 32 32 32 32 32 1 1 23 18 18 18 18 18 18 18 18 18 18 
16 16 16 16 16 16 16 16 16 16 16 16 16 16 16 16 16 16 16 16 16 16 16 16 16 16 16 16 16 16 16 16 16 16 16 16 16 16 16 16 16 16 16 16 16 16 16 16 8 3 7 16 16 16 2 1 1 16 16 16 16 1 1 32 135 136 136 136 136 136 136 136 136 137 32 1 1 1 1 32 175 176 176 176 176 177 32 1 1 23 18 18 18 18 18 18 18 18 18 18 
16 16 16 16 16 16 16 16 16 16 16 16 16 16 16 16 16 16 16 16 16 16 16 16 16 16 16 16 16 16 16 16 16 16 16 16 16 16 16 16 16 16 16 16 16 16 16 16 8 3 7 1 16 16 16 1 1 1 16 16 1 1 1 32 135 136 136 136 136 136 136 136 136 137 32 1 1 1 1 223 184 184 184 184 184 185 32 1 1 23 18 19 18 18 18 18 18 18 18 18 
16 16 16 16 16 16 16 16 16 16 16 16 16 16 16 16 16 16 16 16 16 16 16 16 16 16 16 16 16 16 16 16 16 16 16 16 16 16 16 16 16 16 16 16 16 16 16 1 8 3 7 1 16 16 16 16 1 1 1 1 1 2 1 32 143 144 144 144 144 144 144 144 144 145 32 1 1 1 1 32 183 184 184 184 184 185 32 1 1 23 18 18 18 18 18 18 18 18 18 18 
16 16 16 16 16 16 16 16 16 16 16 16 16 16 16 16 16 16 16 16 16 16 16 16 16 16 16 16 16 16 16 16 16 16 16 16 16 16 16 16 16 16 16 16 16 16 1 1 8 3 7 2 16 16 16 16 16 1 1 1 1 1 1 32 32 32 32 32 32 32 32 32 32 32 32 1 1 1 1 32 183 184 184 184 184 185 32 1 1 23 18 18 18 18 18 18 18 18 18 18 
16 16 16 16 16 16 16 16 16 16 16 16 16 16 16 16 16 16 16 16 16 16 16 16 16 16 16 16 16 16 16 16 16 16 16 16 16 16 16 16 16 16 16 16 16 1 1 1 8 3 7 1 16 16 16 16 16 16 16 16 16 1 1 1 1 1 16 16 16 16 16 1 1 1 1 1 1 1 16 32 191 192 192 192 192 193 32 1 1 23 18 18 18 18 18 18 18 18 18 18 
16 16 16 16 16 16 16 16 16 16 16 1 1 1 1 1 1 1 1 1 1 1 1 1 1 16 1 1 1 1 1 1 1 1 1 1 1 1 1 1 1 1 1 1 1 1 1 2 8 3 7 1 1 16 16 16 16 16 16 16 16 16 1 1 1 2 1 1 1 1 1 1 1 1 16 1 1 1 16 32 32 32 32 32 32 32 32 2 1 23 18 18 18 18 18 18 18 18 18 18 
1 1 16 1 1 2 1 16 16 16 16 1 1 1 1 1 1 16 1 1 1 1 1 1 1 1 1 1 1 1 1 2 1 1 1 1 1 1 2 1 1 1 16 1 1 1 1 1 8 3 7 1 1 1 1 16 16 16 16 16 16 16 1 1 1 1 1 1 1 1 1 1 1 16 16 16 1 1 1 1 1 1 1 1 1 16 1 1 1 23 18 18 18 18 18 18 18 18 18 18 
10 10 10 10 10 10 10 10 13 16 16 12 10 10 10 10 10 10 10 10 10 10 10 10 10 10 10 10 10 10 10 10 10 10 10 10 10 10 10 10 10 10 10 10 10 10 10 10 11 3 9 10 10 10 10 10 10 10 10 10 10 10 10 10 10 10 10 10 10 10 10 10 10 10 10 10 10 10 10 13 1 1 1 1 1 1 1 1 1 23 18 18 18 18 18 18 18 18 18 18 
3 3 3 3 3 3 3 3 7 16 16 8 3 3 3 3 3 3 3 3 3 3 3 3 3 3 3 3 3 3 3 3 3 3 3 3 3 3 3 3 3 3 3 3 3 3 3 3 3 3 3 3 3 3 3 3 3 3 3 3 3 3 3 3 3 3 3 3 3 3 3 3 3 3 3 3 3 3 3 7 1 16 16 16 16 1 1 1 1 23 18 18 18 18 18 18 18 18 18 18 
5 5 5 5 5 5 5 5 15 16 16 14 5 5 5 5 5 5 5 5 5 5 5 5 5 5 5 5 6 3 4 5 5 5 5 5 5 5 5 5 5 5 5 5 5 5 5 5 6 3 4 5 5 5 5 5 5 5 5 5 5 5 5 5 5 5 5 5 5 5 5 5 5 5 5 5 5 5 5 15 16 16 16 16 16 16 1 1 1 23 18 18 18 18 18 18 18 18 18 18 
1 1 1 1 16 16 16 1 1 16 16 1 1 1 1 1 2 1 1 1 1 1 1 1 1 1 1 1 8 3 7 1 1 1 1 1 1 1 1 1 1 16 1 1 1 1 1 1 8 3 7 1 2 16 1 1 1 1 1 1 1 1 1 1 1 1 1 1 1 1 1 1 1 2 1 1 1 1 1 1 16 16 16 16 16 16 16 1 1 23 18 18 18 18 18 18 18 18 18 18 
16 16 16 16 16 16 16 16 16 16 16 16 16 1 1 1 16 16 1 1 1 1 16 16 16 16 1 1 8 3 7 1 1 16 1 16 16 16 16 16 16 16 16 16 16 16 1 1 8 3 7 1 1 1 1 16 16 16 16 16 1 1 1 1 1 1 1 16 1 1 1 1 1 1 1 1 1 1 1 1 1 16 16 16 16 16 16 1 1 23 18 18 18 18 18 18 18 18 18 18 
16 16 16 16 16 16 16 16 16 16 16 16 1 1 1 16 16 16 16 16 16 16 16 16 16 16 16 1 8 3 7 1 1 16 16 16 16 16 16 16 16 16 16 16 16 16 16 1 8 3 7 1 1 16 16 16 16 16 16 16 1 1 2 1 1 1 1 1 1 1 16 1 1 1 1 1 1 1 1 1 1 1 1 1 1 1 1 2 1 23 18 18 19 18 18 18 18 18 18 18 
16 16 16 16 16 16 16 16 16 16 16 1 1 1 16 16 16 16 16 16 16 16 16 16 16 16 16 1 14 5 15 2 1 16 16 16 16 16 16 16 16 16 16 16 16 16 16 1 8 3 7 1 1 16 16 16 16 16 16 1 1 1 1 1 16 1 1 1 1 1 1 1 1 1 1 1 16 32 32 32 32 32 32 32 223 32 1 1 1 23 18 18 18 18 18 18 18 18 18 18 
16 16 16 16 16 16 16 16 16 16 16 1 2 1 16 16 1 1 1 1 1 1 1 1 1 1 1 1 1 1 1 1 1 1 1 1 1 1 1 1 1 1 1 1 16 16 16 1 8 3 7 1 16 16 16 16 16 16 1 2 1 1 1 1 1 1 1 1 16 16 16 1 1 1 1 1 32 32 127 128 128 128 128 128 137 32 1 1 1 23 18 18 18 18 18 18 18 18 18 18 
16 16 16 16 16 16 16 16 16 16 16 1 1 1 1 1 1 32 32 32 32 32 32 32 32 32 32 32 32 223 32 32 32 32 32 32 32 32 32 32 32 1 1 1 1 16 16 1 8 3 7 1 16 16 16 16 1 1 1 1 1 1 1 1 20 21 21 21 21 21 22 16 1 1 1 1 32 127 169 136 136 136 136 136 137 32 1 1 1 23 18 18 18 18 18 18 18 18 18 18 
16 16 16 16 16 16 16 16 16 16 16 1 1 1 2 32 32 32 175 176 176 176 176 176 176 176 176 176 176 184 176 176 176 176 176 176 176 176 176 177 32 32 32 1 1 16 16 1 8 3 7 1 1 1 1 1 1 1 1 1 1 1 20 21 31 18 18 18 18 19 30 22 1 1 1 1 32 135 136 136 136 136 136 136 137 32 16 1 1 23 18 18 18 18 18 18 18 18 18 18 
16 16 16 16 16 16 16 16 16 16 16 1 1 1 1 32 175 176 217 184 184 184 184 184 184 184 184 184 184 184 184 184 184 184 184 184 184 184 184 215 176 177 32 1 1 1 16 1 8 3 9 10 10 10 10 10 10 13 1 1 1 20 31 18 18 18 18 18 18 18 18 24 1 1 2 1 32 135 136 136 136 136 151 144 145 32 16 1 1 23 18 18 18 18 18 18 18 18 18 18 
16 16 16 16 16 16 16 16 16 16 16 1 1 1 32 32 183 184 184 184 184 184 184 184 184 184 184 184 184 184 184 184 184 184 184 184 184 184 184 184 184 185 32 32 1 1 1 1 8 3 3 3 3 3 3 3 3 7 1 1 1 23 18 18 19 18 18 18 18 18 18 24 1 1 1 1 32 143 144 144 144 144 145 32 32 32 1 1 1 23 18 18 18 18 18 18 18 18 18 18 
16 16 16 16 16 16 16 16 16 16 16 1 1 1 32 175 217 184 184 184 184 184 184 184 184 184 184 184 184 184 184 184 184 184 184 184 184 184 184 184 184 215 177 32 1 1 1 1 8 3 4 5 5 5 5 5 5 15 1 1 1 23 18 18 18 18 18 18 18 18 28 27 1 1 1 1 32 32 32 32 32 32 32 32 16 16 1 1 16 23 18 18 18 18 18 18 18 18 18 18 
16 16 16 16 16 16 16 16 16 16 16 1 1 1 32 183 184 184 184 184 184 184 184 184 184 184 184 184 184 184 184 184 184 184 184 184 184 184 184 184 184 184 185 32 1 1 2 1 8 3 7 1 1 16 16 1 1 1 16 1 16 25 26 29 18 18 18 18 19 28 27 1 1 1 1 1 1 1 1 1 1 1 1 1 1 1 1 1 1 23 18 18 18 18 18 18 18 18 18 18 
16 16 16 16 16 16 16 16 16 16 16 1 1 1 32 183 184 184 184 184 184 184 184 184 184 184 184 184 184 184 184 184 184 184 184 184 184 184 184 184 184 184 185 32 16 1 1 1 8 3 7 1 16 16 16 1 1 1 1 1 1 16 16 25 29 18 18 28 26 27 16 1 1 1 1 16 1 1 1 1 1 1 1 1 1 1 1 1 1 23 18 18 18 18 18 18 18 18 18 18 
16 16 16 16 16 16 16 16 16 16 16 1 1 1 32 183 184 184 184 184 184 184 184 184 184 184 184 184 184 184 184 184 184 184 184 184 184 184 184 184 184 184 185 32 16 1 1 1 8 3 7 1 16 1 1 1 2 1 1 1 1 1 16 16 25 26 26 27 16 16 1 1 1 16 16 16 16 16 1 1 32 32 32 32 32 32 32 32 1 23 18 18 18 18 18 18 18 18 18 18 
16 16 16 16 16 16 16 16 16 16 16 1 1 1 32 183 184 184 184 184 184 184 184 184 184 184 184 184 184 184 184 184 184 184 184 184 184 184 184 184 184 184 185 32 1 1 1 1 8 3 7 1 1 1 1 1 1 1 1 1 1 1 1 1 1 1 1 1 1 1 1 1 1 1 1 1 16 1 1 1 32 79 80 80 80 80 81 32 1 23 18 18 18 18 18 18 18 19 18 18 
16 16 16 16 16 16 16 16 16 16 16 1 2 1 32 183 184 184 184 184 184 184 184 184 184 184 184 184 184 184 184 184 184 184 184 184 184 184 184 184 184 184 185 32 1 1 16 1 8 3 7 1 1 1 16 1 1 16 16 16 16 1 1 1 1 1 1 1 1 1 1 1 1 1 1 1 1 1 1 1 32 87 88 88 88 88 89 32 1 23 18 18 18 18 18 18 18 18 18 18 
16 16 16 16 16 16 16 16 16 16 16 1 1 1 32 183 184 184 184 184 184 184 184 184 184 184 184 184 184 184 184 184 184 184 184 184 184 184 184 184 184 184 185 32 1 1 1 1 8 3 7 1 2 1 1 1 16 16 32 32 32 32 32 223 32 32 1 1 1 32 32 223 32 32 16 16 1 1 1 16 32 95 105 88 88 88 89 32 1 23 18 18 18 18 18 18 18 18 18 18 
16 16 16 16 16 16 16 16 16 16 16 1 1 1 32 183 184 184 184 184 184 184 184 184 184 184 184 184 184 184 184 184 184 184 184 184 184 184 184 184 184 184 185 32 1 2 1 1 8 3 7 1 1 1 1 1 16 16 32 127 128 128 128 136 129 32 16 1 16 32 175 184 177 32 32 32 32 16 1 1 32 32 87 88 88 88 89 32 1 23 18 18 18 18 18 18 18 18 18 18 
16 16 16 16 16 16 16 16 16 16 16 1 1 1 32 183 184 184 184 184 184 184 184 184 184 184 184 184 184 184 184 184 184 184 184 184 184 184 184 184 184 184 185 32 1 1 1 1 8 3 7 1 16 1 1 1 16 16 32 135 136 136 136 136 137 32 16 1 16 32 183 184 215 176 176 177 32 32 16 1 1 32 87 88 88 88 89 32 1 23 18 18 18 18 18 18 18 18 18 18 
16 16 16 16 16 16 16 16 16 16 16 1 1 1 32 191 201 184 184 184 184 184 184 184 184 184 184 184 184 184 184 184 184 184 184 184 184 184 184 184 184 184 193 32 1 1 16 1 8 3 7 1 16 16 16 1 1 16 32 135 136 136 136 136 137 32 16 1 16 32 183 184 184 184 184 215 177 32 16 1 1 223 96 105 88 103 97 32 1 23 18 18 18 18 18 18 18 18 18 18 
16 16 16 16 16 16 16 16 16 16 16 1 1 1 32 32 183 184 184 184 184 184 184 184 184 184 184 184 184 184 184 184 184 184 184 184 184 184 184 184 184 185 32 32 1 16 16 1 8 3 7 1 16 16 16 16 1 16 32 143 144 144 144 144 145 32 16 1 16 32 191 192 192 192 192 192 193 32 16 1 1 32 32 95 96 97 32 32 1 23 18 18 18 18 18 18 18 18 18 18 
16 16 16 16 16 16 16 16 16 16 16 1 1 1 1 32 191 192 201 184 184 184 184 184 184 184 184 184 184 184 184 184 184 184 184 184 184 184 184 199 192 193 32 1 1 16 16 1 8 3 7 1 16 16 16 16 1 16 32 32 32 32 32 32 32 32 16 1 16 32 32 32 32 32 32 32 32 32 16 1 1 16 32 32 32 32 32 16 1 23 18 18 18 18 18 18 18 18 18 18 
16 16 16 16 16 16 16 16 16 16 16 1 1 16 2 32 32 32 191 192 192 192 192 192 192 192 192 192 192 184 192 192 192 192 192 192 192 192 192 193 32 32 32 1 16 16 16 1 8 3 7 1 16 16 16 16 1 1 1 1 1 1 1 1 1 1 1 1 1 16 16 16 16 16 16 16 16 16 16 1 1 16 16 16 16 16 16 1 1 23 18 18 18 18 18 18 18 18 18 18 
16 16 16 16 16 16 16 16 16 16 16 1 16 16 1 1 1 32 32 32 32 32 32 32 32 32 32 32 32 223 32 32 32 32 32 32 32 32 32 32 32 1 1 1 16 16 1 1 8 3 7 1 16 16 16 16 16 16 16 16 16 16 16 16 16 16 16 16 1 1 1 2 1 1 1 1 1 1 1 1 1 1 1 1 1 1 1 1 1 23 18 18 18 18 18 18 18 18 18 18 
16 16 16 16 16 16 16 16 16 16 16 1 16 16 16 1 1 1 1 1 1 1 1 1 1 1 1 1 1 1 1 1 1 1 1 1 1 1 1 1 1 1 1 1 1 1 1 1 8 3 7 1 16 16 16 16 16 16 16 16 16 16 16 16 16 16 16 16 16 16 16 16 16 16 16 16 16 16 16 16 16 16 1 2 1 1 1 2 1 23 18 19 18 18 18 18 18 18 18 18 
16 16 16 16 16 16 16 16 16 16 16 1 16 1 1 1 1 1 1 1 1 2 1 1 1 1 1 1 1 1 1 2 1 1 1 1 1 1 1 1 1 1 1 1 1 1 1 1 8 3 7 1 16 16 16 16 16 16 16 16 16 16 16 16 16 16 16 16 16 16 16 16 16 16 16 16 16 16 16 16 16 16 16 1 1 1 1 1 16 23 18 18 18 18 18 18 18 18 18 18 
16 16 16 16 16 16 16 16 16 16 16 1 1 1 1 1 16 16 16 16 16 16 16 16 16 16 16 1 1 1 1 1 16 16 16 16 16 16 1 16 16 16 16 16 1 1 1 1 8 3 7 1 16 16 16 16 16 16 16 16 16 16 16 16 16 16 16 16 16 16 16 16 16 16 16 16 16 16 16 16 16 16 16 16 16 16 1 1 16 23 18 18 18 18 18 18 18 18 19 18 
16 16 16 16 16 16 16 16 16 16 16 1 1 1 16 16 16 16 1 1 16 16 16 16 16 16 16 16 1 1 1 16 16 16 16 16 16 16 16 16 16 16 16 16 16 1 1 1 8 3 7 1 16 16 16 16 16 16 16 16 16 16 16 16 16 16 16 16 16 16 16 16 16 16 16 16 16 16 16 16 1 1 1 16 16 16 16 1 16 23 18 18 18 18 18 18 18 18 18 18 
16 16 16 16 16 16 16 16 16 16 16 1 1 16 16 16 16 16 16 16 16 16 16 16 16 16 16 16 16 1 16 16 16 16 16 16 16 16 16 16 16 16 16 16 16 16 1 16 8 3 7 1 16 16 16 16 16 16 16 16 16 16 16 16 16 16 16 16 16 16 16 16 16 16 16 16 1 1 1 1 1 1 1 1 1 16 16 1 2 23 18 18 18 18 18 18 18 18 18 18 
16 16 16 16 16 16 16 16 16 16 16 1 16 16 16 16 16 16 16 16 16 16 16 16 16 16 16 16 16 1 16 16 16 16 16 16 16 16 16 16 16 16 16 16 16 16 1 1 8 3 7 1 16 16 16 16 16 16 16 1 1 1 1 1 1 1 1 1 2 1 1 1 1 1 1 1 1 1 1 66 66 66 66 66 1 1 16 16 1 23 18 18 18 18 18 18 18 18 18 18 
16 16 16 16 16 16 16 16 16 16 16 1 16 16 16 16 16 16 16 16 16 16 16 16 16 16 16 1 1 1 16 16 16 16 16 16 16 16 16 16 16 16 16 16 16 16 1 1 8 3 7 1 16 16 16 16 16 16 1 1 2 1 1 1 1 16 16 16 16 16 16 16 16 16 16 16 1 1 1 66 34 34 34 66 1 1 2 16 16 23 18 18 18 18 18 18 18 18 18 18 
16 16 16 16 16 16 16 16 16 16 16 1 16 16 16 16 16 16 16 16 16 16 16 16 16 16 16 2 1 1 16 16 16 16 16 16 16 16 16 16 16 16 16 16 16 16 16 1 8 3 7 1 16 16 16 16 16 1 1 1 1 1 1 1 16 16 16 16 16 16 16 16 16 16 16 16 1 1 1 66 34 35 34 66 1 1 16 16 16 23 18 18 18 18 18 18 18 18 18 18 
16 16 16 16 16 16 16 16 16 16 16 1 1 16 16 16 16 16 16 16 16 16 16 16 16 16 16 16 1 1 1 16 16 16 16 16 16 16 16 16 16 16 16 16 16 16 16 1 8 3 7 1 16 16 16 16 16 1 1 1 1 1 1 1 16 16 16 16 16 16 16 16 16 16 16 16 1 1 1 66 34 34 34 66 1 1 16 16 16 23 18 18 18 18 18 18 18 18 18 18 
16 16 16 16 16 16 16 16 16 16 16 1 1 1 16 16 1 1 1 1 1 1 16 16 16 16 16 16 1 1 1 16 16 16 16 16 16 16 16 16 16 16 16 16 16 16 16 1 14 5 15 1 16 16 16 16 16 1 16 1 1 1 1 1 1 16 16 16 16 16 16 16 16 16 16 16 16 16 1 66 66 1 66 66 1 16 16 16 16 23 18 18 18 18 18 18 18 18 18 18 
16 16 16 16 16 16 16 16 16 16 16 1 1 1 2 1 1 1 1 1 1 1 1 16 16 16 16 1 1 2 1 16 16 16 16 16 16 16 16 16 16 16 16 16 16 16 16 1 1 1 1 1 16 16 16 16 16 16 1 1 1 1 1 1 1 1 16 16 16 16 16 16 16 16 16 16 16 16 1 1 1 1 1 1 1 16 16 16 16 23 18 18 18 18 18 18 18 18 18 18 
16 16 16 16 16 16 16 16 16 16 16 1 1 1 1 1 16 16 16 1 1 1 1 1 1 1 1 1 1 1 1 16 16 16 16 16 16 16 16 16 16 16 16 16 16 16 16 1 1 1 1 1 16 16 16 16 16 16 16 1 1 1 1 1 2 1 16 16 16 16 16 16 16 16 16 16 16 16 16 16 16 16 16 16 16 16 16 16 16 23 18 18 18 18 18 18 18 18 18 18 
16 16 16 16 16 16 16 16 16 16 16 1 1 1 1 16 16 16 1 2 1 1 1 1 1 16 16 1 1 1 1 1 1 1 1 1 1 1 1 1 1 1 1 16 16 16 16 1 1 1 1 1 16 16 16 16 16 16 16 16 16 16 16 16 1 1 1 1 16 16 16 16 16 16 16 16 16 16 16 16 16 16 16 16 16 16 16 16 16 23 18 18 18 18 18 18 19 18 18 18 
16 16 16 16 16 16 16 16 16 16 16 16 16 16 16 16 16 1 1 1 1 1 1 1 1 1 16 16 16 16 16 16 1 1 1 16 16 16 16 16 16 16 1 1 1 16 16 1 1 1 2 1 16 16 16 16 16 16 16 16 16 16 16 16 16 1 1 1 1 1 1 1 1 1 1 1 1 1 1 1 16 16 16 16 1 16 16 16 16 23 18 18 18 18 18 18 18 18 18 18 
16 16 16 16 16 16 16 16 16 16 16 16 16 16 16 16 16 16 16 16 1 16 1 1 1 1 1 16 16 16 16 1 1 1 1 1 16 16 16 16 16 16 16 1 1 16 1 1 1 1 1 1 16 16 16 16 16 16 16 16 16 16 16 16 16 16 16 16 16 16 16 16 16 16 1 1 1 1 1 1 1 1 1 1 1 1 16 16 1 23 18 18 18 18 18 18 18 18 18 18 
16 16 16 16 16 16 16 16 16 16 16 16 16 16 16 16 16 16 16 16 16 16 16 16 1 1 1 1 16 16 16 16 1 1 16 1 1 1 16 16 16 16 16 16 1 1 2 1 1 1 1 1 16 16 16 16 16 16 16 16 16 16 16 16 16 16 16 16 16 16 16 16 16 1 1 1 1 1 1 1 1 1 1 1 1 1 1 1 1 23 18 18 18 18 18 18 18 18 18 18 
16 16 16 16 16 16 16 16 16 16 16 16 16 16 16 16 16 16 16 16 16 16 16 16 16 16 2 1 1 1 1 1 1 1 1 1 1 1 1 1 1 1 16 1 1 1 1 1 1 1 1 1 16 16 16 16 16 16 16 16 16 16 16 16 16 16 16 16 16 16 16 1 1 1 1 1 1 1 1 1 2 2 1 1 1 1 1 1 1 23 18 18 18 18 18 18 18 18 18 18 
16 16 16 16 16 16 16 16 16 16 32 32 32 32 16 16 16 16 16 16 16 16 16 16 16 16 16 1 1 1 1 1 1 1 1 1 2 1 1 1 1 1 1 1 1 1 16 16 1 1 1 1 16 16 16 16 16 16 16 16 16 16 16 16 16 16 16 16 16 1 1 2 1 1 1 1 16 1 1 1 1 1 1 1 1 1 1 2 1 23 18 18 18 18 18 18 18 18 18 18 
16 16 16 16 16 16 16 16 16 16 32 69 69 32 16 16 16 16 16 16 1 1 1 16 16 16 16 16 1 1 1 1 1 1 1 1 1 1 16 16 16 16 16 16 16 16 16 16 16 1 1 1 1 1 16 16 16 16 16 16 16 16 16 16 16 16 16 1 1 1 1 1 1 1 16 16 16 16 1 1 1 1 1 16 16 1 1 1 1 23 18 18 18 18 18 18 18 18 18 18 
16 16 16 16 16 16 16 16 16 16 32 69 69 223 1 1 1 1 1 1 1 16 1 1 1 1 1 1 1 16 16 16 16 16 1 1 1 1 1 1 16 16 16 16 16 16 16 16 16 16 1 1 1 1 1 1 16 16 16 16 16 16 16 16 16 1 1 1 1 1 1 1 1 1 1 16 16 1 1 1 16 16 16 1 1 1 1 1 1 23 18 18 18 18 18 18 18 18 18 18 
16 16 16 16 16 16 16 16 16 16 32 32 32 32 16 16 16 16 16 16 16 16 16 16 16 16 16 16 16 16 16 16 16 16 16 16 16 1 1 1 1 1 1 1 1 1 1 1 1 1 1 1 1 1 1 1 1 1 1 1 2 1 1 1 1 1 1 1 1 1 16 1 1 2 1 1 1 1 1 1 1 1 1 1 1 1 1 1 2 23 18 18 18 18 18 18 18 18 18 18 
16 16 16 16 16 16 16 16 16 16 16 16 16 16 16 16 16 16 16 16 16 16 16 16 16 16 16 16 16 16 16 16 16 16 16 16 16 16 16 16 16 16 16 16 16 16 16 16 16 16 16 16 16 16 16 16 16 16 16 16 16 16 16 16 16 16 16 16 16 16 16 16 16 16 16 16 16 16 16 16 16 16 16 16 16 16 16 16 16 23 18 18 18 18 18 18 18 18 18 18 
16 16 16 16 16 16 16 16 16 16 16 16 16 16 16 16 16 16 16 16 16 16 16 16 16 16 16 16 16 16 16 16 16 16 16 16 16 16 16 16 16 16 16 16 16 16 16 16 16 16 16 16 16 16 16 16 16 16 16 16 16 16 16 16 16 16 16 16 16 16 16 16 16 16 16 16 16 16 16 16 16 16 16 16 16 16 16 16 16 23 18 18 19 18 18 18 18 18 18 18 
16 16 16 16 16 16 16 16 16 16 16 16 16 16 16 16 16 16 16 16 16 16 16 16 16 16 16 16 16 16 16 16 16 16 16 16 16 16 16 16 16 16 16 16 16 16 16 16 16 16 16 16 16 16 16 16 16 16 16 16 16 16 16 16 16 16 16 16 16 16 16 16 16 16 16 16 16 16 16 16 16 16 16 16 16 16 16 16 16 23 18 18 18 18 18 18 18 18 18 18 
16 16 16 16 16 16 16 16 16 16 16 16 16 16 16 16 16 16 16 16 16 16 16 16 16 16 16 16 16 16 16 16 16 16 16 16 16 16 16 16 16 16 16 16 16 16 16 16 16 16 16 16 16 16 16 16 16 16 16 16 16 16 16 16 16 16 16 16 16 16 16 16 16 16 16 16 16 16 16 16 16 16 16 16 16 16 16 16 16 23 18 18 18 18 18 18 18 18 18 18 
16 16 16 16 16 16 16 16 16 16 16 16 16 16 16 16 16 16 16 16 16 16 16 16 16 16 16 16 16 16 16 16 16 16 16 16 16 16 16 16 16 16 16 16 16 16 16 16 16 16 16 16 16 16 16 16 16 16 16 16 16 16 16 16 16 16 16 16 16 16 16 16 16 16 16 16 16 16 16 16 16 16 16 16 16 16 16 16 16 23 18 18 18 18 18 18 18 18 18 18 
